%%%%%                        
%%%%%                        
%%%%%                        
%%%%%                        
%%%%%                        
%%%%%                        
%%%%%                        
%%%%%                        
%%%%%                     %% 
%%%%                     %%% 
%%%%                   %%%%% 
%%%%                  %%%%%% 
%%%                  %%%%%%  
%%%                 %%%%%%   
%%%                %%%%%%    
%%                 %%%%%%    
%%                %%%%%.  %  
%%%%              %%%%.. %%  
%%%%%             %%%%.  %%  
%%%%%             %%%%. %%   
%%%%%%            %%%.  %%   
%%%%%%            %%%% %%    
%%%%%%           %%%%  %%    
%%%%%            %%%% %%     
%%%%%           %%%%  %%     
%%%%%           %%%  %%%    %
%%%%%          %%% % %%     %
%%%%           %% %% %%    %%
%%%%           % %%%%%     %%
%%%%          % %%%%%%    %%%
%%% P          %%%%%%%    %%%
%%%           %%%%%%%    %%%%
%%           %%%%%%%%    %%%%
%%           %% %%%%     %%%%
%           %%%%%%%%    %%%%%
%           %%%%%%%%    %%%%%
            %%%%%%%     %%%%%
           %%%%%%%%     %%%%%
           %% %%%%     %%%%%%
          %%%%%%%%     %%%%%%
          %% .%%%%     %%%%%%
         %%%.%%%%%      %%%%%
         %%..%%%%%      %%%%%
        %%%..%%%%%       %%%%
        %% .%%%%%          %%
           %%%%%%          %%
          %%%%%%%         %%%
          %%%%%%          %%%
         %%%%%%           %%%
        %%%%%%           %%%%
        %%%%%            %%%%
        %%%              %%%%
        %               %%%%%
                        %%%%%
                        %%%%%
                        %%%%%
                        %%%%%
                        %%%%%
                        %%%%%
                        %%%%%
                        %%%%%
